#####################################............T
#####################################.............
#####################################.............
####.............................####.############
####.###########################.####.############
####.###########################.####.############
####.###########################.####.############
####.###.....................###.####.############
####.###.###################.###.####.############
####.###.###################.###.####.############
####.###.###R................###.####.############
####.###.#######################.####.############
####.###.#######################.####.############
####.###.#######################.####.############
####.###.........................####.############
####.################################.############
####.################################.############
####.################################.############
####..................................############
##################################################
##################################################
##################################################
##################################################
##################################################
##################################################
##################################################
##################################################
##################################################
##################################################
##################################################
##################################################
####..................................############
####.################################.############
####.################################.############
####.################################.############
####.###..........................###.############
####.###.########################.###.############
####.###.########################.###.############
####.###.########################.###.############
####.###.###R.................###.###.############
####.###.####################.###.###.############
####.###.####################.###.###.############
####.###......................###.###.############
####.############################.###.############
####.############################.###.############
####.############################.###.############
####..............................###.############
#####################################.............
#####################################.............
#####################################............T
